date,openfaas/faas stars,openfaas/faas cumulative,fission/fission stars,fission/fission cumulative,kubeless/kubeless stars,kubeless/kubeless cumulative
2016-11-08,0,0,2,2,0,0
2016-11-09,0,0,2,4,0,0
2016-11-10,0,0,4,8,0,0
2016-11-11,0,0,0,8,0,0
2016-11-12,0,0,0,8,0,0
2016-11-13,0,0,0,8,0,0
2016-11-14,0,0,1,9,0,0
2016-11-15,0,0,2,11,0,0
2016-11-16,0,0,30,41,0,0
2016-11-17,0,0,38,79,0,0
2016-11-18,0,0,19,98,0,0
2016-11-19,0,0,6,104,0,0
2016-11-20,0,0,3,107,0,0
2016-11-21,0,0,4,111,0,0
2016-11-22,0,0,8,119,0,0
2016-11-23,0,0,2,121,0,0
2016-11-24,0,0,3,124,0,0
2016-11-25,0,0,0,124,0,0
2016-11-26,0,0,0,124,0,0
2016-11-27,0,0,1,125,0,0
2016-11-28,0,0,5,130,0,0
2016-11-29,0,0,42,172,0,0
2016-11-30,0,0,28,200,0,0
2016-12-01,0,0,10,210,0,0
2016-12-02,0,0,2,212,0,0
2016-12-03,0,0,1,213,0,0
2016-12-04,0,0,0,213,0,0
2016-12-05,0,0,3,216,0,0
2016-12-06,0,0,23,239,1,1
2016-12-07,0,0,12,251,4,5
2016-12-08,0,0,2,253,8,13
2016-12-09,0,0,2,255,19,32
2016-12-10,0,0,0,255,11,43
2016-12-11,0,0,27,282,7,50
2016-12-12,0,0,23,305,8,58
2016-12-13,0,0,11,316,4,62
2016-12-14,0,0,3,319,6,68
2016-12-15,0,0,0,319,2,70
2016-12-16,0,0,1,320,3,73
2016-12-17,0,0,2,322,2,75
2016-12-18,0,0,2,324,1,76
2016-12-19,0,0,1,325,0,76
2016-12-20,0,0,3,328,4,80
2016-12-21,0,0,2,330,1,81
2016-12-22,0,0,2,332,0,81
2016-12-23,0,0,2,334,1,82
2016-12-24,0,0,2,336,1,83
2016-12-25,0,0,1,337,0,83
2016-12-26,0,0,0,337,0,83
2016-12-27,0,0,3,340,0,83
2016-12-28,0,0,1,341,1,84
2016-12-29,0,0,0,341,1,85
2016-12-30,0,0,1,342,0,85
2016-12-31,0,0,0,342,1,86
2017-01-01,0,0,0,342,0,86
2017-01-02,0,0,2,344,0,86
2017-01-03,0,0,0,344,1,87
2017-01-04,15,15,6,350,0,87
2017-01-05,24,39,77,427,1,88
2017-01-06,7,46,18,445,0,88
2017-01-07,1,47,6,451,1,89
2017-01-08,5,52,5,456,0,89
2017-01-09,1,53,8,464,1,90
2017-01-10,3,56,3,467,0,90
2017-01-11,2,58,4,471,0,90
2017-01-12,3,61,7,478,1,91
2017-01-13,3,64,34,512,0,91
2017-01-14,0,64,18,530,0,91
2017-01-15,0,64,11,541,0,91
2017-01-16,1,65,14,555,0,91
2017-01-17,4,69,20,575,1,92
2017-01-18,1,70,9,584,3,95
2017-01-19,1,71,10,594,2,97
2017-01-20,1,72,5,599,2,99
2017-01-21,1,73,0,599,0,99
2017-01-22,2,75,2,601,0,99
2017-01-23,13,88,0,601,2,101
2017-01-24,3,91,11,612,5,106
2017-01-25,6,97,19,631,1,107
2017-01-26,10,107,23,654,1,108
2017-01-27,1,108,16,670,1,109
2017-01-28,0,108,12,682,2,111
2017-01-29,1,109,12,694,0,111
2017-01-30,4,113,143,837,3,114
2017-01-31,3,116,242,1079,3,117
2017-02-01,5,121,69,1148,0,117
2017-02-02,1,122,27,1175,3,120
2017-02-03,20,142,33,1208,3,123
2017-02-04,10,152,11,1219,1,124
2017-02-05,3,155,17,1236,1,125
2017-02-06,5,160,30,1266,9,134
2017-02-07,2,162,12,1278,4,138
2017-02-08,1,163,10,1288,3,141
2017-02-09,2,165,6,1294,1,142
2017-02-10,1,166,4,1298,1,143
2017-02-11,1,167,6,1304,0,143
2017-02-12,9,176,4,1308,4,147
2017-02-13,6,182,8,1316,2,149
2017-02-14,0,182,7,1323,0,149
2017-02-15,0,182,3,1326,0,149
2017-02-16,0,182,3,1329,0,149
2017-02-17,7,189,8,1337,1,150
2017-02-18,5,194,5,1342,1,151
2017-02-19,3,197,1,1343,5,156
2017-02-20,0,197,9,1352,3,159
2017-02-21,1,198,7,1359,2,161
2017-02-22,1,199,14,1373,0,161
2017-02-23,1,200,7,1380,0,161
2017-02-24,1,201,6,1386,0,161
2017-02-25,2,203,5,1391,0,161
2017-02-26,3,206,5,1396,1,162
2017-02-27,0,206,16,1412,0,162
2017-02-28,0,206,11,1423,2,164
2017-03-01,4,210,8,1431,0,164
2017-03-02,5,215,4,1435,1,165
2017-03-03,0,215,5,1440,4,169
2017-03-04,1,216,5,1445,1,170
2017-03-05,2,218,2,1447,1,171
2017-03-06,3,221,10,1457,2,173
2017-03-07,4,225,9,1466,1,174
2017-03-08,1,226,8,1474,1,175
2017-03-09,0,226,7,1481,2,177
2017-03-10,3,229,8,1489,2,179
2017-03-11,0,229,6,1495,2,181
2017-03-12,1,230,0,1495,1,182
2017-03-13,2,232,5,1500,3,185
2017-03-14,0,232,2,1502,1,186
2017-03-15,0,232,2,1504,2,188
2017-03-16,1,233,3,1507,5,193
2017-03-17,1,234,4,1511,3,196
2017-03-18,0,234,1,1512,2,198
2017-03-19,0,234,3,1515,2,200
2017-03-20,0,234,6,1521,4,204
2017-03-21,3,237,8,1529,4,208
2017-03-22,230,467,15,1544,4,212
2017-03-23,126,593,7,1551,2,214
2017-03-24,25,618,10,1561,1,215
2017-03-25,16,634,2,1563,0,215
2017-03-26,8,642,6,1569,1,216
2017-03-27,6,648,4,1573,11,227
2017-03-28,18,666,9,1582,3,230
2017-03-29,45,711,4,1586,1,231
2017-03-30,77,788,8,1594,2,233
2017-03-31,34,822,2,1596,4,237
2017-04-01,19,841,3,1599,0,237
2017-04-02,12,853,2,1601,0,237
2017-04-03,15,868,4,1605,2,239
2017-04-04,2,870,3,1608,1,240
2017-04-05,23,893,5,1613,0,240
2017-04-06,6,899,3,1616,9,249
2017-04-07,11,910,7,1623,2,251
2017-04-08,4,914,7,1630,2,253
2017-04-09,11,925,3,1633,1,254
2017-04-10,10,935,5,1638,0,254
2017-04-11,6,941,4,1642,2,256
2017-04-12,5,946,5,1647,1,257
2017-04-13,27,973,4,1651,6,263
2017-04-14,5,978,4,1655,1,264
2017-04-15,10,988,1,1656,1,265
2017-04-16,8,996,1,1657,1,266
2017-04-17,26,1022,1,1658,1,267
2017-04-18,10,1032,7,1665,2,269
2017-04-19,9,1041,3,1668,6,275
2017-04-20,493,1534,5,1673,2,277
2017-04-21,42,1576,3,1676,2,279
2017-04-22,13,1589,3,1679,1,280
2017-04-23,6,1595,0,1679,1,281
2017-04-24,15,1610,3,1682,0,281
2017-04-25,25,1635,3,1685,0,281
2017-04-26,27,1662,3,1688,4,285
2017-04-27,15,1677,13,1701,3,288
2017-04-28,13,1690,4,1705,1,289
2017-04-29,7,1697,4,1709,5,294
2017-04-30,24,1721,1,1710,3,297
2017-05-01,9,1730,2,1712,3,300
2017-05-02,11,1741,2,1714,4,304
2017-05-03,6,1747,4,1718,3,307
2017-05-04,11,1758,6,1724,3,310
2017-05-05,10,1768,4,1728,3,313
2017-05-06,9,1777,5,1733,0,313
2017-05-07,7,1784,0,1733,0,313
2017-05-08,9,1793,5,1738,0,313
2017-05-09,8,1801,2,1740,2,315
2017-05-10,5,1806,3,1743,2,317
2017-05-11,6,1812,3,1746,1,318
2017-05-12,8,1820,4,1750,7,325
2017-05-13,6,1826,1,1751,1,326
2017-05-14,5,1831,2,1753,5,331
2017-05-15,5,1836,6,1759,0,331
2017-05-16,2,1838,2,1761,2,333
2017-05-17,5,1843,4,1765,8,341
2017-05-18,4,1847,8,1773,5,346
2017-05-19,13,1860,7,1780,2,348
2017-05-20,6,1866,4,1784,1,349
2017-05-21,9,1875,2,1786,2,351
2017-05-22,8,1883,3,1789,1,352
2017-05-23,6,1889,7,1796,8,360
2017-05-24,8,1897,6,1802,9,369
2017-05-25,7,1904,8,1810,6,375
2017-05-26,6,1910,3,1813,3,378
2017-05-27,6,1916,3,1816,4,382
2017-05-28,2,1918,1,1817,1,383
2017-05-29,4,1922,1,1818,1,384
2017-05-30,2,1924,6,1824,1,385
2017-05-31,3,1927,2,1826,10,395
2017-06-01,8,1935,4,1830,9,404
2017-06-02,3,1938,4,1834,0,404
2017-06-03,6,1944,2,1836,1,405
2017-06-04,1,1945,4,1840,2,407
2017-06-05,4,1949,3,1843,0,407
2017-06-06,10,1959,7,1850,2,409
2017-06-07,3,1962,2,1852,3,412
2017-06-08,4,1966,0,1852,2,414
2017-06-09,5,1971,1,1853,3,417
2017-06-10,1,1972,2,1855,1,418
2017-06-11,3,1975,2,1857,1,419
2017-06-12,6,1981,10,1867,1,420
2017-06-13,4,1985,7,1874,6,426
2017-06-14,11,1996,8,1882,6,432
2017-06-15,5,2001,6,1888,8,440
2017-06-16,2,2003,5,1893,2,442
2017-06-17,2,2005,7,1900,1,443
2017-06-18,5,2010,4,1904,2,445
2017-06-19,2,2012,2,1906,4,449
2017-06-20,3,2015,10,1916,6,455
2017-06-21,4,2019,9,1925,3,458
2017-06-22,6,2025,11,1936,2,460
2017-06-23,5,2030,10,1946,2,462
2017-06-24,3,2033,5,1951,0,462
2017-06-25,3,2036,3,1954,1,463
2017-06-26,6,2042,9,1963,9,472
2017-06-27,6,2048,8,1971,3,475
2017-06-28,5,2053,3,1974,4,479
2017-06-29,16,2069,6,1980,6,485
2017-06-30,6,2075,5,1985,8,493
2017-07-01,3,2078,2,1987,18,511
2017-07-02,4,2082,0,1987,11,522
2017-07-03,3,2085,4,1991,20,542
2017-07-04,3,2088,6,1997,11,553
2017-07-05,6,2094,5,2002,9,562
2017-07-06,8,2102,8,2010,7,569
2017-07-07,6,2108,8,2018,11,580
2017-07-08,2,2110,5,2023,3,583
2017-07-09,4,2114,4,2027,4,587
2017-07-10,6,2120,4,2031,2,589
2017-07-11,7,2127,8,2039,4,593
2017-07-12,6,2133,9,2048,0,593
2017-07-13,6,2139,7,2055,2,595
2017-07-14,7,2146,5,2060,2,597
2017-07-15,1,2147,1,2061,0,597
2017-07-16,1,2148,2,2063,0,597
2017-07-17,9,2157,6,2069,0,597
2017-07-18,5,2162,3,2072,5,602
2017-07-19,5,2167,6,2078,8,610
2017-07-20,11,2178,3,2081,2,612
2017-07-21,3,2181,3,2084,3,615
2017-07-22,4,2185,1,2085,0,615
2017-07-23,2,2187,1,2086,1,616
2017-07-24,7,2194,1,2087,3,619
2017-07-25,13,2207,2,2089,1,620
2017-07-26,12,2219,4,2093,6,626
2017-07-27,5,2224,9,2102,3,629
2017-07-28,2,2226,1,2103,4,633
2017-07-29,5,2231,2,2105,3,636
2017-07-30,9,2240,1,2106,2,638
2017-07-31,20,2260,2,2108,1,639
2017-08-01,1,2261,2,2110,7,646
2017-08-02,6,2267,2,2112,6,652
2017-08-03,16,2283,2,2114,2,654
2017-08-04,1,2284,6,2120,1,655
2017-08-05,10,2294,2,2122,0,655
2017-08-06,12,2306,2,2124,2,657
2017-08-07,3,2309,3,2127,4,661
2017-08-08,6,2315,4,2131,0,661
2017-08-09,49,2364,5,2136,6,667
2017-08-10,40,2404,6,2142,8,675
2017-08-11,22,2426,8,2150,5,680
2017-08-12,10,2436,3,2153,3,683
2017-08-13,21,2457,3,2156,3,686
2017-08-14,174,2631,10,2166,3,689
2017-08-15,119,2750,6,2172,6,695
2017-08-16,80,2830,9,2181,3,698
2017-08-17,32,2862,4,2185,9,707
2017-08-18,23,2885,7,2192,2,709
2017-08-19,293,3178,3,2195,2,711
2017-08-20,258,3436,2,2197,2,713
2017-08-21,433,3869,5,2202,5,718
2017-08-22,266,4135,3,2205,11,729
2017-08-23,142,4277,9,2214,19,748
2017-08-24,106,4383,2,2216,10,758
2017-08-25,59,4442,8,2224,7,765
2017-08-26,45,4487,1,2225,1,766
2017-08-27,43,4530,5,2230,3,769
2017-08-28,105,4635,14,2244,8,777
2017-08-29,62,4697,8,2252,6,783
2017-08-30,32,4729,1,2253,34,817
2017-08-31,70,4799,4,2257,50,867
2017-09-01,36,4835,1,2258,24,891
2017-09-02,15,4850,2,2260,19,910
2017-09-03,18,4868,2,2262,4,914
2017-09-04,37,4905,4,2266,7,921
2017-09-05,53,4958,3,2269,9,930
2017-09-06,33,4991,6,2275,8,938
2017-09-07,26,5017,0,2275,2,940
2017-09-08,23,5040,2,2277,6,946
2017-09-09,19,5059,0,2277,3,949
2017-09-10,9,5068,3,2280,5,954
2017-09-11,20,5088,2,2282,13,967
2017-09-12,31,5119,7,2289,10,977
2017-09-13,32,5151,8,2297,15,992
2017-09-14,14,5165,5,2302,7,999
2017-09-15,25,5190,3,2305,8,1007
2017-09-16,6,5196,0,2305,2,1009
2017-09-17,4,5200,5,2310,3,1012
2017-09-18,38,5238,4,2314,2,1014
2017-09-19,30,5268,2,2316,3,1017
2017-09-20,21,5289,2,2318,6,1023
2017-09-21,16,5305,3,2321,6,1029
2017-09-22,15,5320,0,2321,4,1033
2017-09-23,17,5337,0,2321,0,1033
2017-09-24,23,5360,2,2323,7,1040
2017-09-25,48,5408,1,2324,3,1043
2017-09-26,38,5446,1,2325,4,1047
2017-09-27,15,5461,3,2328,2,1049
2017-09-28,31,5492,3,2331,7,1056
2017-09-29,26,5518,5,2336,9,1065
2017-09-30,10,5528,2,2338,4,1069
2017-10-01,16,5544,2,2340,3,1072
2017-10-02,20,5564,3,2343,3,1075
2017-10-03,13,5577,4,2347,7,1082
2017-10-04,27,5604,8,2355,2,1084
2017-10-05,23,5627,6,2361,3,1087
2017-10-06,26,5653,4,2365,7,1094
2017-10-07,18,5671,2,2367,3,1097
2017-10-08,26,5697,2,2369,3,1100
2017-10-09,37,5734,5,2374,6,1106
2017-10-10,19,5753,3,2377,5,1111
2017-10-11,12,5765,4,2381,3,1114
2017-10-12,49,5814,6,2387,7,1121
2017-10-13,31,5845,3,2390,5,1126
2017-10-14,15,5860,1,2391,2,1128
2017-10-15,10,5870,5,2396,2,1130
2017-10-16,27,5897,5,2401,7,1137
2017-10-17,35,5932,9,2410,3,1140
2017-10-18,30,5962,7,2417,5,1145
2017-10-19,43,6005,7,2424,7,1152
2017-10-20,30,6035,7,2431,10,1162
2017-10-21,17,6052,1,2432,6,1168
2017-10-22,11,6063,2,2434,6,1174
2017-10-23,26,6089,5,2439,8,1182
2017-10-24,26,6115,4,2443,6,1188
2017-10-25,39,6154,1,2444,1,1189
2017-10-26,21,6175,9,2453,10,1199
2017-10-27,14,6189,8,2461,3,1202
2017-10-28,21,6210,8,2469,1,1203
2017-10-29,24,6234,4,2473,2,1205
2017-10-30,36,6270,9,2482,9,1214
2017-10-31,27,6297,2,2484,4,1218
2017-11-01,32,6329,5,2489,9,1227
2017-11-02,36,6365,6,2495,9,1236
2017-11-03,31,6396,2,2497,5,1241
2017-11-04,28,6424,4,2501,1,1242
2017-11-05,23,6447,1,2502,2,1244
2017-11-06,29,6476,3,2505,2,1246
2017-11-07,30,6506,4,2509,7,1253
2017-11-08,15,6521,2,2511,1,1254
2017-11-09,19,6540,3,2514,1,1255
2017-11-10,15,6555,4,2518,2,1257
2017-11-11,9,6564,5,2523,4,1261
2017-11-12,9,6573,2,2525,0,1261
2017-11-13,28,6601,4,2529,3,1264
2017-11-14,34,6635,5,2534,6,1270
2017-11-15,28,6663,5,2539,6,1276
2017-11-16,35,6698,1,2540,1,1277
2017-11-17,24,6722,6,2546,1,1278
2017-11-18,8,6730,2,2548,2,1280
2017-11-19,20,6750,4,2552,1,1281
2017-11-20,29,6779,3,2555,12,1293
2017-11-21,22,6801,7,2562,7,1300
2017-11-22,17,6818,7,2569,6,1306
2017-11-23,13,6831,3,2572,6,1312
2017-11-24,13,6844,5,2577,6,1318
2017-11-25,3,6847,1,2578,3,1321
2017-11-26,5,6852,2,2580,3,1324
2017-11-27,19,6871,3,2583,4,1328
2017-11-28,16,6887,1,2584,8,1336
2017-11-29,15,6902,3,2587,6,1342
2017-11-30,13,6915,4,2591,8,1350
2017-12-01,17,6932,4,2595,8,1358
2017-12-02,8,6940,1,2596,5,1363
2017-12-03,12,6952,4,2600,1,1364
2017-12-04,16,6968,2,2602,9,1373
2017-12-05,8,6976,3,2605,10,1383
2017-12-06,9,6985,8,2613,3,1386
2017-12-07,19,7004,5,2618,6,1392
2017-12-08,14,7018,4,2622,10,1402
2017-12-09,8,7026,2,2624,4,1406
2017-12-10,12,7038,4,2628,11,1417
2017-12-11,16,7054,3,2631,17,1434
2017-12-12,17,7071,8,2639,19,1453
2017-12-13,15,7086,9,2648,8,1461
2017-12-14,46,7132,1,2649,8,1469
2017-12-15,30,7162,14,2663,7,1476
2017-12-16,7,7169,2,2665,5,1481
2017-12-17,11,7180,4,2669,3,1484
2017-12-18,13,7193,5,2674,6,1490
2017-12-19,43,7236,5,2679,8,1498
2017-12-20,37,7273,3,2682,9,1507
2017-12-21,23,7296,2,2684,6,1513
2017-12-22,12,7308,6,2690,4,1517
2017-12-23,12,7320,1,2691,4,1521
2017-12-24,7,7327,3,2694,5,1526
2017-12-25,14,7341,1,2695,3,1529
2017-12-26,12,7353,3,2698,7,1536
2017-12-27,24,7377,3,2701,9,1545
2017-12-28,23,7400,2,2703,2,1547
2017-12-29,22,7422,2,2705,2,1549
2017-12-30,18,7440,3,2708,3,1552
2017-12-31,16,7456,3,2711,3,1555
2018-01-01,8,7464,1,2712,2,1557
2018-01-02,29,7493,3,2715,6,1563
2018-01-03,23,7516,2,2717,9,1572
2018-01-04,23,7539,1,2718,10,1582
2018-01-05,23,7562,10,2728,2,1584
2018-01-06,20,7582,1,2729,1,1585
2018-01-07,11,7593,3,2732,9,1594
2018-01-08,24,7617,1,2733,4,1598
2018-01-09,42,7659,2,2735,9,1607
2018-01-10,31,7690,2,2737,5,1612
2018-01-11,27,7717,1,2738,6,1618
2018-01-12,33,7750,4,2742,8,1626
2018-01-13,12,7762,3,2745,2,1628
2018-01-14,8,7770,4,2749,6,1634
2018-01-15,17,7787,2,2751,3,1637
2018-01-16,29,7816,29,2780,22,1659
2018-01-17,25,7841,11,2791,11,1670
2018-01-18,29,7870,2,2793,8,1678
2018-01-19,22,7892,2,2795,8,1686
2018-01-20,16,7908,4,2799,4,1690
2018-01-21,10,7918,4,2803,2,1692
2018-01-22,18,7936,5,2808,3,1695
2018-01-23,14,7950,6,2814,10,1705
2018-01-24,24,7974,5,2819,12,1717
2018-01-25,17,7991,3,2822,11,1728
2018-01-26,11,8002,2,2824,8,1736
2018-01-27,16,8018,2,2826,5,1741
2018-01-28,11,8029,4,2830,6,1747
2018-01-29,21,8050,5,2835,5,1752
2018-01-30,20,8070,6,2841,7,1759
2018-01-31,15,8085,1,2842,8,1767
2018-02-01,16,8101,5,2847,4,1771
2018-02-02,14,8115,3,2850,7,1778
2018-02-03,16,8131,1,2851,3,1781
2018-02-04,8,8139,0,2851,3,1784
2018-02-05,13,8152,4,2855,6,1790
2018-02-06,25,8177,3,2858,5,1795
2018-02-07,13,8190,4,2862,9,1804
2018-02-08,21,8211,4,2866,14,1818
2018-02-09,14,8225,4,2870,4,1822
2018-02-10,12,8237,0,2870,3,1825
2018-02-11,6,8243,3,2873,3,1828
2018-02-12,22,8265,1,2874,10,1838
2018-02-13,20,8285,2,2876,11,1849
2018-02-14,16,8301,2,2878,6,1855
2018-02-15,9,8310,1,2879,8,1863
2018-02-16,15,8325,5,2884,1,1864
2018-02-17,8,8333,3,2887,1,1865
2018-02-18,6,8339,5,2892,2,1867
2018-02-19,29,8368,4,2896,8,1875
2018-02-20,27,8395,7,2903,8,1883
2018-02-21,19,8414,2,2905,6,1889
2018-02-22,23,8437,2,2907,8,1897
2018-02-23,32,8469,5,2912,10,1907
2018-02-24,14,8483,8,2920,8,1915
2018-02-25,16,8499,1,2921,5,1920
2018-02-26,21,8520,4,2925,4,1924
2018-02-27,20,8540,3,2928,4,1928
2018-02-28,20,8560,4,2932,5,1933
2018-03-01,11,8571,0,2932,9,1942
2018-03-02,19,8590,7,2939,3,1945
2018-03-03,14,8604,3,2942,4,1949
2018-03-04,10,8614,0,2942,0,1949
2018-03-05,19,8633,8,2950,5,1954
2018-03-06,18,8651,3,2953,9,1963
2018-03-07,16,8667,3,2956,14,1977
2018-03-08,16,8683,3,2959,7,1984
2018-03-09,10,8693,1,2960,6,1990
2018-03-10,9,8702,2,2962,7,1997
2018-03-11,13,8715,1,2963,10,2007
2018-03-12,13,8728,5,2968,3,2010
2018-03-13,17,8745,4,2972,9,2019
2018-03-14,28,8773,3,2975,8,2027
2018-03-15,15,8788,2,2977,4,2031
2018-03-16,19,8807,2,2979,5,2036
2018-03-17,14,8821,4,2983,4,2040
2018-03-18,12,8833,2,2985,7,2047
2018-03-19,36,8869,3,2988,8,2055
2018-03-20,21,8890,4,2992,7,2062
2018-03-21,18,8908,12,3004,8,2070
2018-03-22,14,8922,2,3006,2,2072
2018-03-23,11,8933,4,3010,9,2081
2018-03-24,8,8941,3,3013,5,2086
2018-03-25,10,8951,3,3016,4,2090
2018-03-26,22,8973,4,3020,16,2106
2018-03-27,34,9007,2,3022,12,2118
2018-03-28,22,9029,6,3028,6,2124
2018-03-29,20,9049,2,3030,8,2132
2018-03-30,15,9064,2,3032,13,2145
2018-03-31,10,9074,1,3033,5,2150
2018-04-01,11,9085,0,3033,3,2153
2018-04-02,12,9097,1,3034,3,2156
2018-04-03,20,9117,8,3042,5,2161
2018-04-04,17,9134,1,3043,6,2167
2018-04-05,15,9149,0,3043,0,2167
2018-04-06,11,9160,2,3045,7,2174
2018-04-07,17,9177,2,3047,3,2177
2018-04-08,8,9185,0,3047,4,2181
2018-04-09,15,9200,4,3051,2,2183
2018-04-10,14,9214,5,3056,5,2188
2018-04-11,15,9229,4,3060,12,2200
2018-04-12,23,9252,5,3065,5,2205
2018-04-13,11,9263,2,3067,11,2216
2018-04-14,6,9269,1,3068,5,2221
2018-04-15,5,9274,1,3069,0,2221
2018-04-16,11,9285,4,3073,6,2227
2018-04-17,12,9297,5,3078,2,2229
2018-04-18,17,9314,4,3082,9,2238
2018-04-19,10,9324,2,3084,4,2242
2018-04-20,14,9338,3,3087,4,2246
2018-04-21,10,9348,0,3087,3,2249
2018-04-22,5,9353,4,3091,2,2251
2018-04-23,19,9372,5,3096,6,2257
2018-04-24,22,9394,5,3101,6,2263
2018-04-25,9,9403,1,3102,14,2277
2018-04-26,16,9419,3,3105,4,2281
2018-04-27,15,9434,2,3107,7,2288
2018-04-28,7,9441,1,3108,2,2290
2018-04-29,3,9444,3,3111,1,2291
2018-04-30,13,9457,5,3116,8,2299
2018-05-01,8,9465,3,3119,9,2308
2018-05-02,18,9483,2,3121,5,2313
2018-05-03,17,9500,4,3125,13,2326
2018-05-04,17,9517,5,3130,6,2332
2018-05-05,9,9526,1,3131,2,2334
2018-05-06,6,9532,1,3132,4,2338
2018-05-07,17,9549,3,3135,9,2347
2018-05-08,17,9566,2,3137,13,2360
2018-05-09,12,9578,2,3139,7,2367
2018-05-10,9,9587,5,3144,10,2377
2018-05-11,15,9602,2,3146,13,2390
2018-05-12,8,9610,3,3149,5,2395
2018-05-13,3,9613,0,3149,3,2398
2018-05-14,11,9624,4,3153,13,2411
2018-05-15,9,9633,2,3155,16,2427
2018-05-16,19,9652,3,3158,8,2435
2018-05-17,19,9671,4,3162,7,2442
2018-05-18,26,9697,3,3165,8,2450
2018-05-19,4,9701,1,3166,4,2454
2018-05-20,5,9706,1,3167,4,2458
2018-05-21,12,9718,0,3167,5,2463
2018-05-22,13,9731,3,3170,6,2469
2018-05-23,12,9743,3,3173,9,2478
2018-05-24,19,9762,5,3178,8,2486
2018-05-25,15,9777,3,3181,8,2494
2018-05-26,7,9784,3,3184,1,2495
2018-05-27,4,9788,3,3187,1,2496
2018-05-28,13,9801,7,3194,10,2506
2018-05-29,11,9812,3,3197,6,2512
2018-05-30,13,9825,6,3203,8,2520
2018-05-31,16,9841,5,3208,5,2525
2018-06-01,15,9856,4,3212,5,2530
2018-06-02,4,9860,4,3216,4,2534
2018-06-03,3,9863,3,3219,8,2542
2018-06-04,9,9872,5,3224,12,2554
2018-06-05,18,9890,1,3225,89,2643
2018-06-06,17,9907,4,3229,62,2705
2018-06-07,14,9921,5,3234,27,2732
2018-06-08,7,9928,2,3236,20,2752
2018-06-09,10,9938,3,3239,9,2761
2018-06-10,8,9946,1,3240,3,2764
2018-06-11,12,9958,4,3244,9,2773
2018-06-12,17,9975,1,3245,11,2784
2018-06-13,15,9990,2,3247,11,2795
2018-06-14,20,10010,4,3251,7,2802
2018-06-15,16,10026,3,3254,5,2807
2018-06-16,6,10032,2,3256,7,2814
2018-06-17,8,10040,1,3257,6,2820
2018-06-18,10,10050,2,3259,7,2827
2018-06-19,13,10063,2,3261,7,2834
2018-06-20,13,10076,3,3264,4,2838
2018-06-21,14,10090,3,3267,9,2847
2018-06-22,13,10103,3,3270,5,2852
2018-06-23,3,10106,2,3272,4,2856
2018-06-24,5,10111,1,3273,3,2859
2018-06-25,11,10122,3,3276,3,2862
2018-06-26,10,10132,3,3279,8,2870
2018-06-27,8,10140,4,3283,17,2887
2018-06-28,21,10161,3,3286,6,2893
2018-06-29,19,10180,4,3290,4,2897
2018-06-30,6,10186,0,3290,3,2900
2018-07-01,9,10195,0,3290,4,2904
2018-07-02,6,10201,4,3294,1,2905
2018-07-03,19,10220,3,3297,10,2915
2018-07-04,9,10229,1,3298,2,2917
2018-07-05,12,10241,3,3301,7,2924
2018-07-06,17,10258,3,3304,7,2931
2018-07-07,4,10262,1,3305,2,2933
2018-07-08,4,10266,1,3306,6,2939
2018-07-09,18,10284,3,3309,10,2949
2018-07-10,15,10299,4,3313,7,2956
2018-07-11,13,10312,2,3315,5,2961
2018-07-12,8,10320,2,3317,4,2965
2018-07-13,15,10335,4,3321,5,2970
2018-07-14,5,10340,1,3322,2,2972
2018-07-15,5,10345,0,3322,3,2975
2018-07-16,15,10360,1,3323,4,2979
2018-07-17,16,10376,2,3325,7,2986
2018-07-18,13,10389,2,3327,4,2990
2018-07-19,10,10399,6,3333,6,2996
2018-07-20,10,10409,2,3335,8,3004
2018-07-21,2,10411,2,3337,2,3006
2018-07-22,5,10416,0,3337,0,3006
2018-07-23,20,10436,2,3339,7,3013
2018-07-24,21,10457,2,3341,8,3021
2018-07-25,15,10472,6,3347,11,3032
2018-07-26,13,10485,2,3349,6,3038
2018-07-27,12,10497,2,3351,2,3040
2018-07-28,6,10503,0,3351,0,3040
2018-07-29,7,10510,1,3352,3,3043
2018-07-30,10,10520,3,3355,2,3045
2018-07-31,11,10531,2,3357,8,3053
2018-08-01,18,10549,3,3360,5,3058
2018-08-02,11,10560,2,3362,4,3062
2018-08-03,16,10576,4,3366,4,3066
2018-08-04,10,10586,1,3367,4,3070
2018-08-05,8,10594,1,3368,1,3071
2018-08-06,16,10610,1,3369,5,3076
2018-08-07,18,10628,4,3373,3,3079
2018-08-08,9,10637,4,3377,4,3083
2018-08-09,6,10643,3,3380,4,3087
2018-08-10,12,10655,2,3382,4,3091
2018-08-11,6,10661,1,3383,2,3093
2018-08-12,8,10669,1,3384,3,3096
2018-08-13,10,10679,2,3386,7,3103
2018-08-14,10,10689,4,3390,8,3111
2018-08-15,14,10703,2,3392,2,3113
2018-08-16,19,10722,4,3396,0,3113
2018-08-17,10,10732,1,3397,8,3121
2018-08-18,7,10739,1,3398,4,3125
2018-08-19,5,10744,1,3399,2,3127
2018-08-20,7,10751,3,3402,12,3139
2018-08-21,7,10758,3,3405,6,3145
2018-08-22,11,10769,4,3409,3,3148
2018-08-23,24,10793,1,3410,5,3153
2018-08-24,8,10801,3,3413,3,3156
2018-08-25,7,10808,0,3413,1,3157
2018-08-26,10,10818,2,3415,5,3162
2018-08-27,10,10828,2,3417,4,3166
2018-08-28,17,10845,3,3420,11,3177
2018-08-29,8,10853,3,3423,4,3181
2018-08-30,10,10863,2,3425,3,3184
2018-08-31,10,10873,0,3425,4,3188
2018-09-01,5,10878,1,3426,4,3192
2018-09-02,9,10887,1,3427,7,3199
2018-09-03,12,10899,2,3429,17,3216
2018-09-04,9,10908,6,3435,8,3224
2018-09-05,18,10926,2,3437,7,3231
2018-09-06,20,10946,1,3438,5,3236
2018-09-07,7,10953,6,3444,8,3244
2018-09-08,8,10961,6,3450,4,3248
2018-09-09,9,10970,3,3453,4,3252
2018-09-10,7,10977,1,3454,10,3262
2018-09-11,15,10992,5,3459,7,3269
2018-09-12,11,11003,1,3460,15,3284
2018-09-13,16,11019,2,3462,4,3288
2018-09-14,8,11027,1,3463,7,3295
2018-09-15,5,11032,1,3464,2,3297
2018-09-16,4,11036,0,3464,1,3298
2018-09-17,20,11056,3,3467,7,3305
2018-09-18,25,11081,0,3467,9,3314
2018-09-19,11,11092,4,3471,13,3327
2018-09-20,9,11101,4,3475,6,3333
2018-09-21,13,11114,2,3477,11,3344
2018-09-22,6,11120,1,3478,3,3347
2018-09-23,7,11127,0,3478,0,3347
2018-09-24,18,11145,2,3480,6,3353
2018-09-25,19,11164,3,3483,10,3363
2018-09-26,11,11175,1,3484,31,3394
2018-09-27,13,11188,1,3485,10,3404
2018-09-28,11,11199,3,3488,4,3408
2018-09-29,9,11208,2,3490,4,3412
2018-09-30,9,11217,2,3492,7,3419
2018-10-01,8,11225,4,3496,4,3423
2018-10-02,4,11229,0,3496,11,3434
2018-10-03,10,11239,1,3497,4,3438
2018-10-04,7,11246,0,3497,10,3448
2018-10-05,5,11251,0,3497,5,3453
2018-10-06,7,11258,0,3497,8,3461
2018-10-07,10,11268,1,3498,6,3467
2018-10-08,11,11279,2,3500,9,3476
2018-10-09,10,11289,4,3504,8,3484
2018-10-10,7,11296,5,3509,9,3493
2018-10-11,9,11305,4,3513,5,3498
2018-10-12,12,11317,5,3518,8,3506
2018-10-13,8,11325,3,3521,3,3509
2018-10-14,3,11328,0,3521,5,3514
2018-10-15,16,11344,5,3526,10,3524
2018-10-16,19,11363,3,3529,5,3529
2018-10-17,17,11380,3,3532,6,3535
2018-10-18,10,11390,4,3536,8,3543
2018-10-19,8,11398,6,3542,7,3550
2018-10-20,4,11402,2,3544,6,3556
2018-10-21,1,11403,1,3545,4,3560
2018-10-22,14,11417,4,3549,6,3566
2018-10-23,11,11428,3,3552,4,3570
2018-10-24,14,11442,0,3552,7,3577
2018-10-25,10,11452,3,3555,7,3584
2018-10-26,14,11466,2,3557,6,3590
2018-10-27,7,11473,1,3558,4,3594
2018-10-28,6,11479,2,3560,5,3599
2018-10-29,18,11497,3,3563,11,3610
2018-10-30,7,11504,4,3567,6,3616
2018-10-31,7,11511,4,3571,6,3622
2018-11-01,6,11517,3,3574,3,3625
2018-11-02,11,11528,5,3579,5,3630
2018-11-03,6,11534,1,3580,6,3636
2018-11-04,5,11539,1,3581,2,3638
2018-11-05,12,11551,2,3583,2,3640
2018-11-06,7,11558,6,3589,7,3647
2018-11-07,7,11565,10,3599,6,3653
2018-11-08,16,11581,1,3600,5,3658
2018-11-09,11,11592,6,3606,8,3666
2018-11-10,9,11601,0,3606,3,3669
2018-11-11,8,11609,0,3606,4,3673
2018-11-12,13,11622,2,3608,4,3677
2018-11-13,26,11648,9,3617,4,3681
2018-11-14,13,11661,9,3626,7,3688
2018-11-15,9,11670,9,3635,5,3693
2018-11-16,10,11680,8,3643,10,3703
2018-11-17,5,11685,3,3646,4,3707
2018-11-18,1,11686,4,3650,4,3711
2018-11-19,26,11712,6,3656,8,3719
2018-11-20,12,11724,2,3658,4,3723
2018-11-21,12,11736,6,3664,3,3726
2018-11-22,8,11744,1,3665,2,3728
2018-11-23,8,11752,5,3670,0,3728
2018-11-24,8,11760,4,3674,6,3734
2018-11-25,4,11764,3,3677,2,3736
2018-11-26,8,11772,4,3681,8,3744
2018-11-27,9,11781,7,3688,5,3749
2018-11-28,15,11796,6,3694,5,3754
2018-11-29,8,11804,5,3699,5,3759
2018-11-30,14,11818,5,3704,10,3769
2018-12-01,9,11827,6,3710,5,3774
2018-12-02,7,11834,4,3714,3,3777
2018-12-03,10,11844,6,3720,11,3788
2018-12-04,8,11852,7,3727,12,3800
2018-12-05,7,11859,4,3731,3,3803
2018-12-06,19,11878,2,3733,5,3808
2018-12-07,41,11919,6,3739,7,3815
2018-12-08,4,11923,4,3743,2,3817
2018-12-09,8,11931,1,3744,1,3818
2018-12-10,19,11950,3,3747,6,3824
2018-12-11,19,11969,7,3754,8,3832
2018-12-12,16,11985,5,3759,15,3847
2018-12-13,11,11996,7,3766,4,3851
2018-12-14,12,12008,5,3771,2,3853
2018-12-15,8,12016,3,3774,3,3856
2018-12-16,3,12019,2,3776,3,3859
2018-12-17,8,12027,5,3781,4,3863
2018-12-18,8,12035,5,3786,8,3871
2018-12-19,14,12049,6,3792,4,3875
2018-12-20,5,12054,3,3795,6,3881
2018-12-21,12,12066,2,3797,3,3884
2018-12-22,6,12072,1,3798,3,3887
2018-12-23,5,12077,1,3799,6,3893
2018-12-24,12,12089,1,3800,4,3897
2018-12-25,10,12099,3,3803,3,3900
2018-12-26,14,12113,0,3803,5,3905
2018-12-27,15,12128,2,3805,5,3910
2018-12-28,5,12133,4,3809,3,3913
2018-12-29,6,12139,3,3812,3,3916
2018-12-30,2,12141,1,3813,6,3922
2018-12-31,3,12144,1,3814,0,3922
2019-01-01,3,12147,1,3815,3,3925
2019-01-02,10,12157,1,3816,3,3928
2019-01-03,8,12165,8,3824,5,3933
2019-01-04,16,12181,4,3828,7,3940
2019-01-05,4,12185,1,3829,2,3942
2019-01-06,6,12191,1,3830,3,3945
2019-01-07,16,12207,5,3835,14,3959
2019-01-08,15,12222,4,3839,5,3964
2019-01-09,10,12232,5,3844,4,3968
2019-01-10,17,12249,3,3847,9,3977
2019-01-11,17,12266,6,3853,5,3982
2019-01-12,11,12277,7,3860,2,3984
2019-01-13,6,12283,2,3862,1,3985
2019-01-14,6,12289,3,3865,6,3991
2019-01-15,22,12311,7,3872,2,3993
2019-01-16,15,12326,4,3876,6,3999
2019-01-17,8,12334,2,3878,3,4002
2019-01-18,13,12347,3,3881,9,4011
2019-01-19,11,12358,1,3882,2,4013
2019-01-20,4,12362,2,3884,3,4016
2019-01-21,15,12377,3,3887,3,4019
2019-01-22,6,12383,1,3888,3,4022
2019-01-23,6,12389,5,3893,6,4028
2019-01-24,11,12400,4,3897,4,4032
2019-01-25,11,12411,5,3902,14,4046
2019-01-26,7,12418,1,3903,3,4049
2019-01-27,8,12426,1,3904,2,4051
2019-01-28,12,12438,3,3907,3,4054
2019-01-29,19,12457,1,3908,4,4058
2019-01-30,19,12476,5,3913,3,4061
2019-01-31,16,12492,6,3919,3,4064
2019-02-01,13,12505,3,3922,3,4067
2019-02-02,10,12515,1,3923,2,4069
2019-02-03,7,12522,1,3924,1,4070
2019-02-04,21,12543,1,3925,6,4076
2019-02-05,27,12570,2,3927,2,4078
2019-02-06,19,12589,1,3928,9,4087
2019-02-07,10,12599,0,3928,2,4089
2019-02-08,9,12608,3,3931,3,4092
2019-02-09,7,12615,8,3939,1,4093
2019-02-10,6,12621,3,3942,3,4096
2019-02-11,10,12631,3,3945,5,4101
2019-02-12,17,12648,5,3950,7,4108
2019-02-13,14,12662,5,3955,2,4110
2019-02-14,15,12677,4,3959,6,4116
2019-02-15,20,12697,2,3961,5,4121
2019-02-16,17,12714,2,3963,4,4125
2019-02-17,16,12730,1,3964,2,4127
2019-02-18,14,12744,3,3967,0,4127
2019-02-19,19,12763,4,3971,5,4132
2019-02-20,10,12773,5,3976,2,4134
2019-02-21,13,12786,3,3979,4,4138
2019-02-22,26,12812,6,3985,5,4143
2019-02-23,20,12832,2,3987,3,4146
2019-02-24,12,12844,0,3987,0,4146
2019-02-25,10,12854,3,3990,9,4155
2019-02-26,18,12872,5,3995,3,4158
2019-02-27,13,12885,2,3997,5,4163
2019-02-28,12,12897,5,4002,6,4169
2019-03-01,10,12907,3,4005,5,4174
2019-03-02,13,12920,3,4008,4,4178
2019-03-03,17,12937,2,4010,5,4183
2019-03-04,18,12955,6,4016,3,4186
2019-03-05,14,12969,4,4020,7,4193
2019-03-06,23,12992,0,4020,8,4201
2019-03-07,23,13015,4,4024,4,4205
2019-03-08,13,13028,7,4031,6,4211
2019-03-09,10,13038,3,4034,4,4215
2019-03-10,8,13046,0,4034,4,4219
2019-03-11,16,13062,5,4039,4,4223
2019-03-12,16,13078,3,4042,10,4233
2019-03-13,16,13094,4,4046,8,4241
2019-03-14,14,13108,4,4050,3,4244
2019-03-15,12,13120,1,4051,7,4251
2019-03-16,7,13127,5,4056,5,4256
2019-03-17,7,13134,2,4058,2,4258
2019-03-18,13,13147,1,4059,3,4261
2019-03-19,19,13166,5,4064,6,4267
2019-03-20,12,13178,1,4065,3,4270
2019-03-21,19,13197,7,4072,4,4274
2019-03-22,12,13209,1,4073,10,4284
2019-03-23,10,13219,3,4076,4,4288
2019-03-24,7,13226,1,4077,3,4291
2019-03-25,18,13244,3,4080,8,4299
2019-03-26,20,13264,2,4082,6,4305
2019-03-27,18,13282,2,4084,8,4313
2019-03-28,15,13297,5,4089,3,4316
2019-03-29,13,13310,4,4093,1,4317
2019-03-30,5,13315,5,4098,1,4318
2019-03-31,5,13320,4,4102,5,4323
2019-04-01,10,13330,6,4108,10,4333
2019-04-02,8,13338,1,4109,4,4337
2019-04-03,14,13352,3,4112,5,4342
2019-04-04,12,13364,6,4118,3,4345
2019-04-05,14,13378,5,4123,5,4350
2019-04-06,7,13385,2,4125,5,4355
2019-04-07,6,13391,1,4126,3,4358
2019-04-08,18,13409,1,4127,8,4366
2019-04-09,11,13420,2,4129,1,4367
2019-04-10,19,13439,2,4131,7,4374
2019-04-11,16,13455,2,4133,6,4380
2019-04-12,16,13471,4,4137,6,4386
2019-04-13,8,13479,3,4140,2,4388
2019-04-14,12,13491,1,4141,3,4391
2019-04-15,13,13504,4,4145,5,4396
2019-04-16,17,13521,6,4151,3,4399
2019-04-17,10,13531,1,4152,7,4406
2019-04-18,6,13537,4,4156,3,4409
2019-04-19,12,13549,2,4158,6,4415
2019-04-20,9,13558,2,4160,4,4419
2019-04-21,3,13561,1,4161,3,4422
2019-04-22,8,13569,1,4162,9,4431
2019-04-23,9,13578,4,4166,6,4437
2019-04-24,7,13585,2,4168,4,4441
2019-04-25,14,13599,4,4172,4,4445
2019-04-26,13,13612,7,4179,4,4449
2019-04-27,6,13618,2,4181,2,4451
2019-04-28,19,13637,0,4181,1,4452
2019-04-29,17,13654,3,4184,6,4458
2019-04-30,14,13668,0,4184,1,4459
2019-05-01,14,13682,3,4187,2,4461
2019-05-02,8,13690,1,4188,4,4465
2019-05-03,14,13704,1,4189,3,4468
2019-05-04,5,13709,2,4191,4,4472
2019-05-05,13,13722,3,4194,1,4473
2019-05-06,8,13730,4,4198,5,4478
2019-05-07,12,13742,7,4205,7,4485
2019-05-08,9,13751,2,4207,10,4495
2019-05-09,11,13762,1,4208,7,4502
2019-05-10,10,13772,2,4210,2,4504
2019-05-11,7,13779,7,4217,4,4508
2019-05-12,3,13782,1,4218,2,4510
2019-05-13,10,13792,2,4220,5,4515
2019-05-14,12,13804,4,4224,4,4519
2019-05-15,14,13818,3,4227,2,4521
2019-05-16,14,13832,7,4234,1,4522
2019-05-17,9,13841,4,4238,5,4527
2019-05-18,5,13846,3,4241,0,4527
2019-05-19,5,13851,0,4241,4,4531
2019-05-20,12,13863,3,4244,4,4535
2019-05-21,13,13876,4,4248,6,4541
2019-05-22,11,13887,1,4249,8,4549
2019-05-23,14,13901,3,4252,3,4552
2019-05-24,13,13914,3,4255,7,4559
2019-05-25,3,13917,1,4256,4,4563
2019-05-26,10,13927,0,4256,0,4563
2019-05-27,18,13945,2,4258,2,4565
2019-05-28,12,13957,0,4258,1,4566
2019-05-29,9,13966,4,4262,6,4572
2019-05-30,9,13975,6,4268,4,4576
2019-05-31,14,13989,1,4269,3,4579
2019-06-01,8,13997,3,4272,3,4582
2019-06-02,10,14007,0,4272,3,4585
2019-06-03,15,14022,2,4274,4,4589
2019-06-04,14,14036,6,4280,5,4594
2019-06-05,15,14051,3,4283,6,4600
2019-06-06,10,14061,0,4283,3,4603
2019-06-07,9,14070,6,4289,6,4609
2019-06-08,7,14077,3,4292,1,4610
2019-06-09,5,14082,0,4292,2,4612
2019-06-10,15,14097,13,4305,1,4613
2019-06-11,9,14106,2,4307,3,4616
2019-06-12,11,14117,2,4309,2,4618
2019-06-13,9,14126,3,4312,7,4625
2019-06-14,12,14138,3,4315,10,4635
2019-06-15,5,14143,2,4317,5,4640
2019-06-16,12,14155,0,4317,4,4644
2019-06-17,27,14182,2,4319,4,4648
2019-06-18,13,14195,2,4321,4,4652
2019-06-19,12,14207,1,4322,4,4656
2019-06-20,15,14222,1,4323,5,4661
2019-06-21,11,14233,6,4329,4,4665
2019-06-22,7,14240,2,4331,2,4667
2019-06-23,7,14247,5,4336,2,4669
2019-06-24,8,14255,3,4339,2,4671
2019-06-25,11,14266,1,4340,3,4674
2019-06-26,16,14282,3,4343,5,4679
2019-06-27,9,14291,1,4344,3,4682
2019-06-28,16,14307,2,4346,3,4685
2019-06-29,4,14311,1,4347,3,4688
2019-06-30,10,14321,0,4347,3,4691
2019-07-01,14,14335,4,4351,3,4694
2019-07-02,15,14350,2,4353,7,4701
2019-07-03,19,14369,5,4358,2,4703
2019-07-04,9,14378,3,4361,4,4707
2019-07-05,10,14388,1,4362,2,4709
2019-07-06,11,14399,4,4366,3,4712
2019-07-07,5,14404,4,4370,2,4714
2019-07-08,16,14420,3,4373,6,4720
2019-07-09,16,14436,4,4377,7,4727
2019-07-10,10,14446,1,4378,2,4729
2019-07-11,26,14472,3,4381,4,4733
2019-07-12,27,14499,5,4386,5,4738
2019-07-13,15,14514,1,4387,4,4742
2019-07-14,9,14523,0,4387,2,4744
2019-07-15,11,14534,2,4389,19,4763
2019-07-16,18,14552,1,4390,8,4771
2019-07-17,14,14566,4,4394,3,4774
2019-07-18,7,14573,3,4397,3,4777
2019-07-19,8,14581,3,4400,3,4780
2019-07-20,11,14592,0,4400,2,4782
2019-07-21,4,14596,1,4401,1,4783
2019-07-22,6,14602,2,4403,3,4786
2019-07-23,11,14613,3,4406,3,4789
2019-07-24,14,14627,2,4408,5,4794
2019-07-25,15,14642,2,4410,1,4795
2019-07-26,20,14662,1,4411,2,4797
2019-07-27,5,14667,3,4414,5,4802
2019-07-28,6,14673,3,4417,2,4804
2019-07-29,14,14687,4,4421,3,4807
2019-07-30,14,14701,2,4423,3,4810
2019-07-31,12,14713,4,4427,5,4815
2019-08-01,12,14725,2,4429,10,4825
2019-08-02,6,14731,1,4430,5,4830
2019-08-03,7,14738,3,4433,2,4832
2019-08-04,10,14748,0,4433,0,4832
2019-08-05,8,14756,1,4434,8,4840
2019-08-06,14,14770,1,4435,4,4844
2019-08-07,8,14778,3,4438,1,4845
2019-08-08,13,14791,1,4439,2,4847
2019-08-09,21,14812,4,4443,1,4848
2019-08-10,7,14819,3,4446,3,4851
2019-08-11,13,14832,1,4447,1,4852
2019-08-12,10,14842,1,4448,0,4852
2019-08-13,8,14850,1,4449,2,4854
2019-08-14,10,14860,0,4449,1,4855
2019-08-15,9,14869,3,4452,4,4859
2019-08-16,13,14882,5,4457,4,4863
2019-08-17,5,14887,1,4458,3,4866
2019-08-18,7,14894,0,4458,1,4867
2019-08-19,12,14906,2,4460,2,4869
2019-08-20,30,14936,5,4465,2,4871
2019-08-21,14,14950,3,4468,7,4878
2019-08-22,7,14957,8,4476,3,4881
2019-08-23,8,14965,4,4480,4,4885
2019-08-24,2,14967,2,4482,1,4886
2019-08-25,6,14973,2,4484,2,4888
2019-08-26,9,14982,2,4486,1,4889
2019-08-27,7,14989,1,4487,3,4892
2019-08-28,11,15000,1,4488,2,4894
2019-08-29,9,15009,1,4489,2,4896
2019-08-30,10,15019,2,4491,5,4901
2019-08-31,9,15028,0,4491,3,4904
2019-09-01,7,15035,2,4493,5,4909
2019-09-02,4,15039,1,4494,1,4910
2019-09-03,8,15047,1,4495,4,4914
2019-09-04,11,15058,0,4495,4,4918
2019-09-05,15,15073,0,4495,4,4922
2019-09-06,12,15085,2,4497,1,4923
2019-09-07,10,15095,1,4498,1,4924
2019-09-08,7,15102,3,4501,2,4926
2019-09-09,7,15109,3,4504,3,4929
2019-09-10,8,15117,3,4507,1,4930
2019-09-11,11,15128,2,4509,1,4931
2019-09-12,9,15137,0,4509,2,4933
2019-09-13,6,15143,3,4512,3,4936
2019-09-14,6,15149,2,4514,1,4937
2019-09-15,6,15155,3,4517,5,4942
2019-09-16,12,15167,3,4520,2,4944
2019-09-17,5,15172,3,4523,3,4947
2019-09-18,11,15183,2,4525,3,4950
2019-09-19,16,15199,3,4528,3,4953
2019-09-20,7,15206,1,4529,1,4954
2019-09-21,4,15210,1,4530,1,4955
2019-09-22,5,15215,3,4533,3,4958
2019-09-23,17,15232,4,4537,8,4966
2019-09-24,16,15248,5,4542,5,4971
2019-09-25,18,15266,2,4544,4,4975
2019-09-26,9,15275,5,4549,2,4977
2019-09-27,7,15282,1,4550,5,4982
2019-09-28,9,15291,1,4551,3,4985
2019-09-29,10,15301,0,4551,1,4986
2019-09-30,13,15314,1,4552,3,4989
2019-10-01,15,15329,0,4552,2,4991
2019-10-02,14,15343,1,4553,4,4995
2019-10-03,6,15349,1,4554,2,4997
2019-10-04,9,15358,2,4556,2,4999
2019-10-05,11,15369,1,4557,2,5001
2019-10-06,7,15376,1,4558,2,5003
2019-10-07,7,15383,1,4559,4,5007
2019-10-08,11,15394,1,4560,1,5008
2019-10-09,6,15400,5,4565,6,5014
2019-10-10,17,15417,2,4567,7,5021
2019-10-11,18,15435,3,4570,2,5023
2019-10-12,13,15448,6,4576,1,5024
2019-10-13,2,15450,2,4578,1,5025
2019-10-14,11,15461,0,4578,1,5026
2019-10-15,6,15467,3,4581,6,5032
2019-10-16,11,15478,11,4592,4,5036
2019-10-17,7,15485,11,4603,4,5040
2019-10-18,14,15499,3,4606,0,5040
2019-10-19,13,15512,4,4610,2,5042
2019-10-20,9,15521,3,4613,5,5047
2019-10-21,14,15535,5,4618,2,5049
2019-10-22,15,15550,8,4626,4,5053
2019-10-23,14,15564,4,4630,5,5058
2019-10-24,14,15578,1,4631,3,5061
2019-10-25,11,15589,2,4633,4,5065
2019-10-26,8,15597,0,4633,4,5069
2019-10-27,6,15603,1,4634,0,5069
2019-10-28,13,15616,1,4635,8,5077
2019-10-29,7,15623,5,4640,2,5079
2019-10-30,16,15639,1,4641,1,5080
2019-10-31,13,15652,4,4645,0,5080
2019-11-01,8,15660,4,4649,7,5087
2019-11-02,5,15665,2,4651,0,5087
2019-11-03,8,15673,1,4652,3,5090
2019-11-04,6,15679,5,4657,1,5091
2019-11-05,15,15694,5,4662,3,5094
2019-11-06,7,15701,3,4665,5,5099
2019-11-07,9,15710,1,4666,8,5107
2019-11-08,12,15722,1,4667,2,5109
2019-11-09,8,15730,1,4668,4,5113
2019-11-10,2,15732,0,4668,1,5114
2019-11-11,5,15737,2,4670,2,5116
2019-11-12,12,15749,4,4674,3,5119
2019-11-13,5,15754,4,4678,8,5127
2019-11-14,6,15760,0,4678,5,5132
2019-11-15,8,15768,2,4680,1,5133
2019-11-16,9,15777,1,4681,1,5134
2019-11-17,9,15786,4,4685,1,5135
2019-11-18,8,15794,2,4687,5,5140
2019-11-19,9,15803,7,4694,5,5145
2019-11-20,5,15808,1,4695,1,5146
2019-11-21,8,15816,10,4705,5,5151
2019-11-22,14,15830,4,4709,2,5153
2019-11-23,5,15835,3,4712,2,5155
2019-11-24,7,15842,2,4714,0,5155
2019-11-25,9,15851,4,4718,3,5158
2019-11-26,7,15858,0,4718,0,5158
2019-11-27,14,15872,0,4718,1,5159
2019-11-28,10,15882,0,4718,5,5164
2019-11-29,7,15889,2,4720,3,5167
2019-11-30,1,15890,1,4721,1,5168
2019-12-01,8,15898,2,4723,2,5170
2019-12-02,15,15913,2,4725,1,5171
2019-12-03,8,15921,0,4725,5,5176
2019-12-04,15,15936,6,4731,7,5183
2019-12-05,21,15957,1,4732,6,5189
2019-12-06,8,15965,7,4739,1,5190
2019-12-07,4,15969,3,4742,6,5196
2019-12-08,2,15971,1,4743,0,5196
2019-12-09,8,15979,3,4746,3,5199
2019-12-10,12,15991,4,4750,5,5204
2019-12-11,10,16001,0,4750,3,5207
2019-12-12,9,16010,3,4753,3,5210
2019-12-13,7,16017,5,4758,3,5213
2019-12-14,11,16028,1,4759,1,5214
2019-12-15,8,16036,2,4761,4,5218
2019-12-16,5,16041,6,4767,2,5220
2019-12-17,9,16050,4,4771,3,5223
2019-12-18,12,16062,3,4774,7,5230
2019-12-19,11,16073,1,4775,0,5230
2019-12-20,11,16084,2,4777,2,5232
2019-12-21,7,16091,1,4778,4,5236
2019-12-22,10,16101,1,4779,1,5237
2019-12-23,14,16115,5,4784,1,5238
2019-12-24,18,16133,4,4788,2,5240
2019-12-25,12,16145,4,4792,2,5242
2019-12-26,10,16155,3,4795,2,5244
2019-12-27,6,16161,1,4796,0,5244
2019-12-28,7,16168,1,4797,4,5248
2019-12-29,9,16177,0,4797,2,5250
2019-12-30,11,16188,4,4801,2,5252
2019-12-31,8,16196,2,4803,0,5252
2020-01-01,6,16202,1,4804,1,5253
2020-01-02,9,16211,5,4809,5,5258
2020-01-03,13,16224,3,4812,1,5259
2020-01-04,5,16229,0,4812,3,5262
2020-01-05,7,16236,0,4812,1,5263
2020-01-06,17,16253,1,4813,2,5265
2020-01-07,14,16267,3,4816,3,5268
2020-01-08,8,16275,2,4818,6,5274
2020-01-09,13,16288,3,4821,3,5277
2020-01-10,10,16298,2,4823,3,5280
2020-01-11,3,16301,1,4824,0,5280
2020-01-12,3,16304,0,4824,1,5281
2020-01-13,16,16320,0,4824,2,5283
2020-01-14,8,16328,1,4825,3,5286
2020-01-15,9,16337,3,4828,8,5294
2020-01-16,5,16342,3,4831,7,5301
2020-01-17,10,16352,3,4834,3,5304
2020-01-18,4,16356,1,4835,0,5304
2020-01-19,8,16364,0,4835,3,5307
2020-01-20,11,16375,3,4838,3,5310
2020-01-21,10,16385,2,4840,3,5313
2020-01-22,7,16392,0,4840,2,5315
2020-01-23,10,16402,1,4841,2,5317
2020-01-24,6,16408,2,4843,0,5317
2020-01-25,7,16415,0,4843,1,5318
2020-01-26,8,16423,1,4844,3,5321
2020-01-27,9,16432,0,4844,5,5326
2020-01-28,8,16440,3,4847,1,5327
2020-01-29,4,16444,2,4849,3,5330
2020-01-30,6,16450,5,4854,1,5331
2020-01-31,8,16458,3,4857,0,5331
2020-02-01,5,16463,2,4859,1,5332
2020-02-02,4,16467,3,4862,1,5333
2020-02-03,6,16473,2,4864,4,5337
2020-02-04,16,16489,1,4865,6,5343
2020-02-05,9,16498,1,4866,3,5346
2020-02-06,7,16505,0,4866,3,5349
2020-02-07,7,16512,1,4867,0,5349
2020-02-08,4,16516,3,4870,1,5350
2020-02-09,6,16522,2,4872,4,5354
2020-02-10,13,16535,2,4874,2,5356
2020-02-11,3,16538,2,4876,5,5361
2020-02-12,13,16551,2,4878,1,5362
2020-02-13,8,16559,6,4884,5,5367
2020-02-14,13,16572,2,4886,0,5367
2020-02-15,10,16582,1,4887,2,5369
2020-02-16,5,16587,1,4888,1,5370
2020-02-17,10,16597,0,4888,2,5372
2020-02-18,9,16606,1,4889,2,5374
2020-02-19,6,16612,2,4891,2,5376
2020-02-20,8,16620,2,4893,5,5381
2020-02-21,10,16630,1,4894,2,5383
2020-02-22,11,16641,3,4897,4,5387
2020-02-23,9,16650,1,4898,4,5391
2020-02-24,12,16662,3,4901,4,5395
2020-02-25,10,16672,3,4904,2,5397
2020-02-26,11,16683,1,4905,2,5399
2020-02-27,18,16701,2,4907,2,5401
2020-02-28,10,16711,3,4910,5,5406
2020-02-29,9,16720,1,4911,2,5408
2020-03-01,10,16730,0,4911,1,5409
2020-03-02,19,16749,2,4913,1,5410
2020-03-03,15,16764,1,4914,4,5414
2020-03-04,11,16775,2,4916,3,5417
2020-03-05,10,16785,2,4918,2,5419
2020-03-06,8,16793,2,4920,2,5421
2020-03-07,6,16799,3,4923,7,5428
2020-03-08,6,16805,0,4923,3,5431
2020-03-09,4,16809,1,4924,3,5434
2020-03-10,9,16818,1,4925,3,5437
2020-03-11,8,16826,1,4926,2,5439
2020-03-12,7,16833,4,4930,2,5441
2020-03-13,12,16845,3,4933,0,5441
2020-03-14,3,16848,1,4934,1,5442
2020-03-15,6,16854,0,4934,1,5443
2020-03-16,6,16860,2,4936,4,5447
2020-03-17,6,16866,2,4938,0,5447
2020-03-18,14,16880,6,4944,5,5452
2020-03-19,6,16886,1,4945,3,5455
2020-03-20,6,16892,3,4948,3,5458
2020-03-21,3,16895,0,4948,0,5458
2020-03-22,7,16902,4,4952,5,5463
2020-03-23,6,16908,3,4955,3,5466
2020-03-24,12,16920,1,4956,3,5469
2020-03-25,7,16927,1,4957,2,5471
2020-03-26,8,16935,1,4958,4,5475
2020-03-27,8,16943,2,4960,4,5479
2020-03-28,6,16949,2,4962,0,5479
2020-03-29,6,16955,3,4965,3,5482
2020-03-30,10,16965,2,4967,4,5486
2020-03-31,13,16978,1,4968,4,5490
2020-04-01,5,16983,3,4971,1,5491
2020-04-02,14,16997,3,4974,1,5492
2020-04-03,12,17009,0,4974,1,5493
2020-04-04,5,17014,1,4975,3,5496
2020-04-05,7,17021,0,4975,1,5497
2020-04-06,9,17030,2,4977,2,5499
2020-04-07,15,17045,3,4980,4,5503
2020-04-08,10,17055,1,4981,5,5508
2020-04-09,8,17063,1,4982,4,5512
2020-04-10,9,17072,1,4983,3,5515
2020-04-11,7,17079,3,4986,5,5520
2020-04-12,8,17087,3,4989,3,5523
2020-04-13,3,17090,2,4991,7,5530
2020-04-14,6,17096,2,4993,2,5532
2020-04-15,9,17105,4,4997,4,5536
2020-04-16,6,17111,0,4997,6,5542
2020-04-17,10,17121,2,4999,3,5545
2020-04-18,10,17131,1,5000,3,5548
2020-04-19,4,17135,5,5005,4,5552
2020-04-20,6,17141,1,5006,6,5558
2020-04-21,10,17151,2,5008,3,5561
2020-04-22,11,17162,4,5012,5,5566
2020-04-23,11,17173,4,5016,3,5569
2020-04-24,12,17185,3,5019,5,5574
2020-04-25,9,17194,3,5022,4,5578
2020-04-26,6,17200,1,5023,4,5582
2020-04-27,9,17209,6,5029,1,5583
2020-04-28,10,17219,4,5033,7,5590
2020-04-29,6,17225,0,5033,2,5592
2020-04-30,7,17232,2,5035,1,5593
2020-05-01,3,17235,1,5036,0,5593
2020-05-02,7,17242,1,5037,4,5597
2020-05-03,6,17248,1,5038,2,5599
2020-05-04,8,17256,0,5038,0,5599
2020-05-05,9,17265,2,5040,6,5605
2020-05-06,5,17270,1,5041,7,5612
2020-05-07,10,17280,2,5043,5,5617
2020-05-08,8,17288,4,5047,6,5623
2020-05-09,4,17292,0,5047,4,5627
2020-05-10,10,17302,4,5051,3,5630
2020-05-11,9,17311,1,5052,3,5633
2020-05-12,6,17317,4,5056,1,5634
2020-05-13,10,17327,6,5062,4,5638
2020-05-14,8,17335,4,5066,3,5641
2020-05-15,10,17345,2,5068,2,5643
2020-05-16,6,17351,0,5068,1,5644
2020-05-17,7,17358,2,5070,0,5644
2020-05-18,7,17365,3,5073,2,5646
2020-05-19,10,17375,1,5074,2,5648
2020-05-20,14,17389,5,5079,2,5650
2020-05-21,9,17398,0,5079,2,5652
2020-05-22,10,17408,1,5080,2,5654
2020-05-23,6,17414,1,5081,2,5656
2020-05-24,6,17420,3,5084,0,5656
2020-05-25,12,17432,1,5085,5,5661
2020-05-26,6,17438,1,5086,4,5665
2020-05-27,14,17452,2,5088,5,5670
2020-05-28,9,17461,0,5088,3,5673
2020-05-29,12,17473,3,5091,6,5679
2020-05-30,14,17487,2,5093,4,5683
2020-05-31,7,17494,0,5093,0,5683
2020-06-01,10,17504,1,5094,3,5686
2020-06-02,15,17519,0,5094,3,5689
2020-06-03,16,17535,2,5096,8,5697
2020-06-04,9,17544,1,5097,5,5702
2020-06-05,9,17553,3,5100,4,5706
2020-06-06,6,17559,3,5103,2,5708
2020-06-07,7,17566,2,5105,4,5712
2020-06-08,5,17571,2,5107,2,5714
2020-06-09,8,17579,4,5111,4,5718
2020-06-10,5,17584,2,5113,2,5720
2020-06-11,9,17593,0,5113,1,5721
2020-06-12,10,17603,2,5115,5,5726
2020-06-13,5,17608,3,5118,0,5726
2020-06-14,3,17611,2,5120,0,5726
2020-06-15,8,17619,2,5122,1,5727
2020-06-16,11,17630,0,5122,2,5729
2020-06-17,4,17634,4,5126,3,5732
2020-06-18,2,17636,3,5129,2,5734
2020-06-19,6,17642,2,5131,4,5738
2020-06-20,6,17648,1,5132,5,5743
2020-06-21,4,17652,3,5135,2,5745
2020-06-22,7,17659,0,5135,2,5747
2020-06-23,8,17667,0,5135,3,5750
2020-06-24,7,17674,2,5137,4,5754
2020-06-25,5,17679,0,5137,1,5755
2020-06-26,4,17683,1,5138,1,5756
2020-06-27,7,17690,0,5138,1,5757
2020-06-28,6,17696,3,5141,5,5762
2020-06-29,5,17701,3,5144,0,5762
2020-06-30,6,17707,1,5145,5,5767
2020-07-01,12,17719,2,5147,3,5770
2020-07-02,9,17728,1,5148,0,5770
2020-07-03,7,17735,2,5150,0,5770
2020-07-04,6,17741,0,5150,3,5773
2020-07-05,3,17744,0,5150,1,5774
2020-07-06,3,17747,1,5151,2,5776
2020-07-07,5,17752,4,5155,0,5776
2020-07-08,10,17762,0,5155,2,5778
2020-07-09,9,17771,2,5157,4,5782
2020-07-10,7,17778,2,5159,0,5782
2020-07-11,1,17779,1,5160,2,5784
2020-07-12,6,17785,2,5162,2,5786
2020-07-13,4,17789,3,5165,1,5787
2020-07-14,13,17802,0,5165,2,5789
2020-07-15,5,17807,4,5169,2,5791
2020-07-16,9,17816,1,5170,2,5793
2020-07-17,5,17821,3,5173,8,5801
2020-07-18,3,17824,0,5173,2,5803
2020-07-19,6,17830,0,5173,2,5805
2020-07-20,6,17836,2,5175,3,5808
2020-07-21,6,17842,7,5182,1,5809
2020-07-22,8,17850,4,5186,5,5814
2020-07-23,10,17860,2,5188,2,5816
2020-07-24,11,17871,1,5189,3,5819
2020-07-25,7,17878,0,5189,0,5819
2020-07-26,5,17883,1,5190,3,5822
2020-07-27,6,17889,4,5194,4,5826
2020-07-28,7,17896,2,5196,5,5831
2020-07-29,14,17910,4,5200,7,5838
2020-07-30,8,17918,1,5201,5,5843
2020-07-31,9,17927,0,5201,4,5847
2020-08-01,7,17934,4,5205,3,5850
2020-08-02,2,17936,2,5207,0,5850
2020-08-03,5,17941,2,5209,5,5855
2020-08-04,8,17949,2,5211,2,5857
2020-08-05,5,17954,1,5212,4,5861
2020-08-06,11,17965,3,5215,1,5862
2020-08-07,8,17973,3,5218,0,5862
2020-08-08,4,17977,1,5219,0,5862
2020-08-09,4,17981,1,5220,1,5863
2020-08-10,7,17988,2,5222,1,5864
2020-08-11,7,17995,4,5226,1,5865
2020-08-12,10,18005,2,5228,2,5867
2020-08-13,9,18014,1,5229,5,5872
2020-08-14,6,18020,1,5230,2,5874
2020-08-15,7,18027,1,5231,0,5874
2020-08-16,3,18030,2,5233,2,5876
2020-08-17,6,18036,1,5234,4,5880
2020-08-18,9,18045,0,5234,3,5883
2020-08-19,5,18050,3,5237,2,5885
2020-08-20,6,18056,2,5239,5,5890
2020-08-21,7,18063,4,5243,3,5893
2020-08-22,5,18068,1,5244,0,5893
2020-08-23,5,18073,0,5244,2,5895
2020-08-24,6,18079,1,5245,1,5896
2020-08-25,7,18086,3,5248,6,5902
2020-08-26,12,18098,2,5250,3,5905
2020-08-27,14,18112,2,5252,1,5906
2020-08-28,6,18118,4,5256,6,5912
2020-08-29,3,18121,0,5256,2,5914
2020-08-30,5,18126,0,5256,2,5916
2020-08-31,6,18132,1,5257,3,5919
2020-09-01,9,18141,1,5258,3,5922
2020-09-02,4,18145,1,5259,4,5926
2020-09-03,10,18155,2,5261,2,5928
2020-09-04,9,18164,3,5264,2,5930
2020-09-05,7,18171,4,5268,7,5937
2020-09-06,17,18188,1,5269,3,5940
2020-09-07,7,18195,1,5270,2,5942
2020-09-08,9,18204,6,5276,2,5944
2020-09-09,3,18207,5,5281,3,5947
2020-09-10,3,18210,1,5282,3,5950
2020-09-11,11,18221,2,5284,0,5950
2020-09-12,5,18226,0,5284,2,5952
2020-09-13,7,18233,3,5287,1,5953
2020-09-14,9,18242,2,5289,0,5953
2020-09-15,9,18251,2,5291,0,5953
2020-09-16,6,18257,3,5294,2,5955
2020-09-17,5,18262,1,5295,4,5959
2020-09-18,7,18269,1,5296,4,5963
2020-09-19,5,18274,0,5296,1,5964
2020-09-20,5,18279,0,5296,0,5964
2020-09-21,5,18284,1,5297,1,5965
2020-09-22,4,18288,4,5301,4,5969
2020-09-23,6,18294,2,5303,1,5970
2020-09-24,9,18303,1,5304,4,5974
2020-09-25,8,18311,0,5304,1,5975
2020-09-26,6,18317,2,5306,1,5976
2020-09-27,4,18321,1,5307,1,5977
2020-09-28,9,18330,1,5308,3,5980
2020-09-29,6,18336,6,5314,5,5985
2020-09-30,10,18346,4,5318,0,5985
2020-10-01,4,18350,8,5326,0,5985
2020-10-02,5,18355,152,5478,1,5986
2020-10-03,3,18358,107,5585,1,5987
2020-10-04,8,18366,6,5591,4,5991
2020-10-05,4,18370,9,5600,4,5995
2020-10-06,3,18373,5,5605,5,6000
2020-10-07,6,18379,3,5608,1,6001
2020-10-08,4,18383,5,5613,4,6005
2020-10-09,4,18387,4,5617,2,6007
2020-10-10,7,18394,4,5621,0,6007
2020-10-11,8,18402,2,5623,2,6009
2020-10-12,11,18413,4,5627,12,6021
2020-10-13,16,18429,3,5630,10,6031
2020-10-14,12,18441,3,5633,8,6039
2020-10-15,3,18444,4,5637,5,6044
2020-10-16,10,18454,3,5640,7,6051
2020-10-17,3,18457,2,5642,2,6053
2020-10-18,4,18461,5,5647,5,6058
2020-10-19,7,18468,2,5649,3,6061
2020-10-20,2,18470,2,5651,4,6065
2020-10-21,5,18475,6,5657,2,6067
2020-10-22,8,18483,1,5658,3,6070
2020-10-23,6,18489,2,5660,2,6072
2020-10-24,8,18497,3,5663,1,6073
2020-10-25,1,18498,1,5664,1,6074
2020-10-26,3,18501,3,5667,6,6080
2020-10-27,7,18508,5,5672,6,6086
2020-10-28,7,18515,1,5673,3,6089
2020-10-29,8,18523,1,5674,2,6091
2020-10-30,10,18533,8,5682,0,6091
2020-10-31,13,18546,2,5684,1,6092
2020-11-01,7,18553,3,5687,1,6093
2020-11-02,12,18565,3,5690,5,6098
2020-11-03,6,18571,2,5692,2,6100
2020-11-04,7,18578,7,5699,2,6102
2020-11-05,9,18587,8,5707,1,6103
2020-11-06,2,18589,1,5708,3,6106
2020-11-07,1,18590,3,5711,0,6106
2020-11-08,5,18595,0,5711,1,6107
2020-11-09,7,18602,5,5716,3,6110
2020-11-10,10,18612,4,5720,4,6114
2020-11-11,5,18617,0,5720,0,6114
2020-11-12,6,18623,3,5723,2,6116
2020-11-13,4,18627,2,5725,4,6120
2020-11-14,8,18635,1,5726,2,6122
2020-11-15,5,18640,2,5728,1,6123
2020-11-16,4,18644,2,5730,2,6125
2020-11-17,13,18657,2,5732,5,6130
2020-11-18,4,18661,1,5733,1,6131
2020-11-19,14,18675,5,5738,3,6134
2020-11-20,6,18681,1,5739,1,6135
2020-11-21,1,18682,2,5741,1,6136
2020-11-22,4,18686,0,5741,2,6138
2020-11-23,4,18690,1,5742,2,6140
2020-11-24,9,18699,1,5743,3,6143
2020-11-25,6,18705,2,5745,3,6146
2020-11-26,7,18712,0,5745,3,6149
2020-11-27,5,18717,1,5746,1,6150
2020-11-28,6,18723,0,5746,3,6153
2020-11-29,6,18729,2,5748,2,6155
2020-11-30,9,18738,4,5752,4,6159
2020-12-01,14,18752,1,5753,4,6163
2020-12-02,10,18762,2,5755,3,6166
2020-12-03,7,18769,0,5755,5,6171
2020-12-04,6,18775,1,5756,2,6173
2020-12-05,5,18780,2,5758,2,6175
2020-12-06,6,18786,0,5758,1,6176
2020-12-07,5,18791,0,5758,1,6177
2020-12-08,4,18795,1,5759,2,6179
2020-12-09,9,18804,0,5759,1,6180
2020-12-10,11,18815,1,5760,4,6184
2020-12-11,14,18829,4,5764,3,6187
2020-12-12,9,18838,0,5764,1,6188
2020-12-13,5,18843,0,5764,2,6190
2020-12-14,12,18855,4,5768,0,6190
2020-12-15,8,18863,1,5769,3,6193
2020-12-16,6,18869,1,5770,1,6194
2020-12-17,6,18875,2,5772,0,6194
2020-12-18,7,18882,2,5774,6,6200
2020-12-19,1,18883,0,5774,1,6201
2020-12-20,5,18888,2,5776,2,6203
2020-12-21,7,18895,2,5778,4,6207
2020-12-22,7,18902,3,5781,2,6209
2020-12-23,7,18909,2,5783,2,6211
2020-12-24,4,18913,1,5784,1,6212
2020-12-25,7,18920,1,5785,2,6214
2020-12-26,6,18926,1,5786,2,6216
2020-12-27,1,18927,2,5788,1,6217
2020-12-28,5,18932,2,5790,2,6219
2020-12-29,3,18935,0,5790,3,6222
2020-12-30,7,18942,0,5790,3,6225
2020-12-31,6,18948,4,5794,3,6228
2021-01-01,2,18950,0,5794,0,6228
2021-01-02,4,18954,5,5799,0,6228
2021-01-03,2,18956,3,5802,6,6234
2021-01-04,8,18964,2,5804,2,6236
2021-01-05,7,18971,1,5805,0,6236
2021-01-06,8,18979,2,5807,2,6238
2021-01-07,5,18984,1,5808,4,6242
2021-01-08,7,18991,1,5809,1,6243
2021-01-09,4,18995,0,5809,4,6247
2021-01-10,8,19003,0,5809,2,6249
2021-01-11,3,19006,1,5810,2,6251
2021-01-12,6,19012,3,5813,1,6252
2021-01-13,6,19018,3,5816,3,6255
2021-01-14,3,19021,8,5824,3,6258
2021-01-15,8,19029,3,5827,1,6259
2021-01-16,2,19031,0,5827,1,6260
2021-01-17,5,19036,0,5827,1,6261
2021-01-18,6,19042,2,5829,1,6262
2021-01-19,4,19046,1,5830,3,6265
2021-01-20,12,19058,4,5834,1,6266
2021-01-21,6,19064,2,5836,1,6267
2021-01-22,9,19073,2,5838,1,6268
2021-01-23,4,19077,1,5839,1,6269
2021-01-24,10,19087,0,5839,3,6272
2021-01-25,10,19097,2,5841,5,6277
2021-01-26,8,19105,1,5842,2,6279
2021-01-27,6,19111,1,5843,2,6281
2021-01-28,6,19117,2,5845,6,6287
2021-01-29,6,19123,1,5846,2,6289
2021-01-30,4,19127,1,5847,1,6290
2021-01-31,3,19130,0,5847,1,6291
2021-02-01,6,19136,1,5848,2,6293
2021-02-02,9,19145,3,5851,2,6295
2021-02-03,9,19154,1,5852,1,6296
2021-02-04,2,19156,5,5857,2,6298
2021-02-05,9,19165,3,5860,5,6303
2021-02-06,11,19176,3,5863,3,6306
2021-02-07,10,19186,2,5865,11,6317
2021-02-08,10,19196,3,5868,3,6320
2021-02-09,5,19201,3,5871,3,6323
2021-02-10,9,19210,1,5872,1,6324
2021-02-11,6,19216,1,5873,2,6326
2021-02-12,6,19222,1,5874,2,6328
2021-02-13,4,19226,3,5877,3,6331
2021-02-14,6,19232,3,5880,1,6332
2021-02-15,7,19239,3,5883,1,6333
2021-02-16,3,19242,1,5884,3,6336
2021-02-17,3,19245,1,5885,2,6338
2021-02-18,7,19252,3,5888,2,6340
2021-02-19,13,19265,2,5890,4,6344
2021-02-20,6,19271,1,5891,1,6345
2021-02-21,1,19272,2,5893,1,6346
2021-02-22,6,19278,6,5899,1,6347
2021-02-23,6,19284,2,5901,7,6354
2021-02-24,5,19289,1,5902,0,6354
2021-02-25,13,19302,3,5905,3,6357
2021-02-26,7,19309,2,5907,1,6358
2021-02-27,6,19315,0,5907,0,6358
2021-02-28,5,19320,0,5907,2,6360
2021-03-01,7,19327,1,5908,4,6364
2021-03-02,7,19334,1,5909,2,6366
2021-03-03,12,19346,1,5910,3,6369
2021-03-04,8,19354,2,5912,3,6372
2021-03-05,11,19365,0,5912,2,6374
2021-03-06,8,19373,0,5912,0,6374
2021-03-07,9,19382,0,5912,2,6376
2021-03-08,4,19386,5,5917,5,6381
2021-03-09,9,19395,1,5918,1,6382
2021-03-10,4,19399,1,5919,4,6386
2021-03-11,11,19410,2,5921,4,6390
2021-03-12,8,19418,3,5924,1,6391
2021-03-13,2,19420,1,5925,3,6394
2021-03-14,6,19426,4,5929,3,6397
2021-03-15,9,19435,2,5931,2,6399
2021-03-16,2,19437,1,5932,3,6402
2021-03-17,3,19440,2,5934,2,6404
2021-03-18,4,19444,4,5938,3,6407
2021-03-19,9,19453,1,5939,2,6409
2021-03-20,3,19456,1,5940,3,6412
2021-03-21,3,19459,4,5944,4,6416
2021-03-22,9,19468,7,5951,2,6418
2021-03-23,10,19478,7,5958,2,6420
2021-03-24,6,19484,4,5962,2,6422
2021-03-25,5,19489,3,5965,1,6423
2021-03-26,16,19505,8,5973,1,6424
2021-03-27,4,19509,4,5977,2,6426
2021-03-28,4,19513,3,5980,0,6426
2021-03-29,9,19522,7,5987,2,6428
2021-03-30,10,19532,6,5993,3,6431
2021-03-31,6,19538,2,5995,3,6434
2021-04-01,2,19540,3,5998,6,6440
2021-04-02,7,19547,9,6007,0,6440
2021-04-03,2,19549,4,6011,0,6440
2021-04-04,4,19553,3,6014,2,6442
2021-04-05,2,19555,3,6017,2,6444
2021-04-06,10,19565,4,6021,2,6446
2021-04-07,6,19571,7,6028,1,6447
2021-04-08,5,19576,4,6032,0,6447
2021-04-09,4,19580,4,6036,1,6448
2021-04-10,6,19586,1,6037,4,6452
2021-04-11,1,19587,3,6040,1,6453
2021-04-12,5,19592,1,6041,0,6453
2021-04-13,6,19598,3,6044,3,6456
2021-04-14,2,19600,1,6045,2,6458